#.!......#
####.....#
#........#
#.......##
#........#
#.####...#
#.......##
#........#
#....##..#
#........#
####.....#
#........#
#.......##
#........#
#.####...#
#.......##
#-.@.....#
##########