#...!....#
#.######.#
#........#
#.......##
#........#
#.####...#
#.......##
#........#
#....##..#
#........#
#..#.....#
#...#....#
#.......##
#........#
#..###...#
#.......##
#-.@.....#
##########