#.!......#
########.#
#........#
#.......##
#........#
#.####...#
#.......##
#........#
#....##..#
#........#
#.##.....#
#...#....#
#.......##
#........#
#..###...#
#.......##
#-.@.....#
##########